################
#~~~~**********#
#~~~~~~~~~~~~~~#
#~~E~~~~~~~~~~~#
#~~~~~~~P~~~~~~#
#~~~~~~~~~~~~~~#
#~~~######~~~~~#
#~~~#E~~~#~~~~~#
#~~~#~~~E~~~~~~#
#~~~#~~~~#~~~~~#
#~~~######~~~~~#
#~~~~~~~~~~~~~~#
#~~~~~~~~~~~~~~#
#~~~~E~~~~~~E~~#
#~***C*~~~*****#
################