################
#~~~~**********#
#~~~~~~~~~~~~~~#
#~~~~~~~~~~~~~~#
#~~~~~~~~~~~~~~#
#~~~~~~~~~~~~~~#
#~~~######~~~~~#
#~~~#~~~~#~~~~~#
#~~~#~~~~~~~~~~#
#~~~#~~~~#~~~~~#
#~~~######~~~~~#
#~~~~~~~~~~~~~~#
#~~~~~~~~~~~~~~#
#~~~~~~~~~~~~~~#
#~***C*~~~*****#
################